11111111
10000001
100P0001
100C0001
100E0001
11111111  