1111111111111111111111111
1000000000000000C01000001
10000000C0000000001111001
100000P00000C000000000101
100000000000000000E000001
1111111111111111111111111