1111111111111111111111111
10000000000C0010001000001
100P0CX000X00000001111001
100000X00C000010000E00101
10000000000000100X0000001
1111111111111111111111111